NO images/wall_n.xpm
SO images/wall_s.xpm
WE images/wall_w.xpm
EA images/wall_e.xpm

F  12, 33, 3
C 126,23,14

        1111111111111111111111111
        1000000010100101000000001
        10110000N0110001001000001
        1001000010000001000000001
111111111011000001111111000000001
100000000011000001110111111111111
11110111111111011100000010001
11110111111111011101010010001
11000000110101011100000000001
10001000000000001100000000001
10000000000000001101011000001
1100000111010101111101111111111
11110111 1110101010111101000001
11111111 1111111111111111111111
