NO images/wall_n.xpm
SO images/wall_s.xpm
WE images/wall_w.xpm
EA images/wall_e.xpm

C 255,0,0     
F 255, 255,50    

        1111111111111111111111111
        1000000010110000000000001
        1011000100110000001000001
        1001000010000000000000001
111111111011000001110000000000001
100000000011000001110111111111111
11110111111111011100000010001
11110111111111011101010010001
11000000110101011100000010001
100010W0000000001100000010001
10000000000000001101010010001
1100000111010101111101111000111
11110111 1110101 101111010001
11111111 11111111111111111111