NO images/cat.xpm
SO images/road.xpm
WE images/Wall1.xpm
EA images/Wall5.xpm

F 220,100,0
C 20,100,0

        1111111111111111111111111
        1000000010110000000000001
        1011000100110000001000001
        1001000010000000000000001      
111111111011000001110000000000001
100000000011000001110111111111111
11110111111111011100000010001        
11110111111111011101010010001
11000000110101011100000010001
10001000000000001100000010001
10000000000000001101010010N01
1100000111010101111101111000111
11110111 1110101 101111010001
11111111 11111111111111111111