111111111111111
1E0000000000001
101001010010001
101001001010101
1P0000000C00C01
111111111111111