111111111
1000P00E1
1CCCCCC1
1111111