11111111111111
1000000E000C01
10000CCCCCCCC1
11111111111111